d z v	d ʐ
s v w	s k w
z v w	z ɡ w
t s v	t ʂ
m b w	m b ɡ
n y n '	ɲ ŋ
t w	t k w
p w	p k w
v h	vʱ
z v	ʐ
n '	ŋ
n j	ɲ d ʒ
z w	z ɡ w
s w	s k w
s v	ʂ
s h	ʃ
z h	ʒ
d y	d ʒ g
t y	t ʃ k
d y	d ʒ g
n y	ɲ
b g	b ʒ
c h	t ʃ
n h	nʱ
m h	mʱ
b h	bʱ
d h	dʱ
v	ʋ
h	ɦ
j	d ʒ 
y	j
