d z v	d ʐ
s v w	s k w
z v w	z g w
t s v	t ʂ
m b w	m b g
t w	t k w
p w	p k w
v h	vʱ
z v	ʐ
n '	ŋ
n j	ɲ d ʒ
z w	z g w
s w	s k w
s v	ʂ
s h	ʃ
z h	ʒ
d y	d ʒ g
t y	t ʃ k
d y	d ʒ g
b g	b ʒ
c h	t ʃ
n h	nʱ
m h	mʱ
b h	bʱ
d h	dʱ
h w	wʱ
v	ʋ
h	ɦ
b	ɓ
d	ɗ
j	d ʒ 
y	j
