Input forms:
VIr	VirOk
TIk	TiCOk
pRiMEr	pRiMerOk
vnUk	vnuCOk
haQOk	haQoCOk
kLEr	kLerOk
kulAk	kulaCOk
tReTjAk	tReTjaCOk
pUDeL	puDeLOk
kLOh	kLehOk
VjUn	VjunOk
rOkot	rokotOk
stOlp	stolpOk
sVEs	sVesOk
sOkol	sokolOk
lubOk	luboCOk
sTEk	sTeCOk
plOtNik	plotNiCOk
kuzovOk	kuzovoCOk
anTikvAr	anTikvarOk
TipUn	TipunOk
RadOk	RadoCOk
MIr	MirOk
obrUb	obrubOk
prUt	prutOk
koBEL	koBeLOk
VErx	VerhOk
polkOvNik	polkovNiCOk
zOb	zobOk
eVEn	eVenOk
glotOk	glotoCOk
pUk	puCOk
stOik	stoiCOk
rOk	roCOk
tOlk	tolCOk
provodNIk	provodNiCOk
tUjes	tujesOk
anTIk	anTiCOk
fOn	fonOk
TEnor	TenorOk
travNIk	travNiCOk
RAd	RadOk
tajNIk	tajNiCOk
KiPatOk	KiPatoCOk
CeRehOk	CeRehoCOk
poluOstrov	poluostrovOk
govorOk	govoroCOk
UgoR	ugoROk
loskUt	loskutOk
MAC	MaCOk
sundUk	sunduCOk
glAz	glazOk
kustOk	kustoCOk
UZel	uZelOk
molodNAk	molodNaCOk
sLEd	sLedOk
bOk	boCOk
suxAR	suxaROk
otLIv	otLivOk
sapOg	sapoQOk
kLIn	kLinOk
podzOl	podzolOk
bAl	balOk
klOk	kloCOk
CeloVEk	CeloVeCOk
xrUp	xrupOk
bRelOk	bReloCOk
pOrox	porohOk
SIg	SiQOk
polTInNik	polTinNiCOk
PErh	PerhOk
sadOk	sadoCOk
kOrob	korobOk
PeUn	PeunOk
xLOst	xLestOk
sPIsok	sPisoCOk
LIs	LisOk
eLEktroHIt	eLektroHitOk
Okorok	okoroCOk
jUs	jusOk
kovIL	koviLOk
dimOk	dimoCOk
vaRENik	vaReNiCOk
kurDUk	kurDuCOk
kAt	katOk
puCOk	puCoCOk
tOpot	topotOk
dobRAk	dobRaCOk
LEs	LesOk
NedoDEl	NedoDelOk
xudOQNik	xudoQNiCOk
kusOk	kusoCOk
boTInok	boTinoCOk
grOxot	groxotOk
mazOk	mazoCOk
godOk	godoCOk
nasLEdNik	nasLedNiCOk
tUh	tuhOk
hUm	humOk
SEVer	SeVerOk
hUt	hutOk
xlOp	xlopOk
BegUn	BegunOk
skAk	skaCOk
razbOjNik	razbojNiCOk
krAj	krajOk
sotrUdNik	sotrudNiCOk
lAn	lanOk
BEg	BeQOk
HIt	HitOk
cAR	caROk
prutOk	prutoCOk
bugorOk	bugoroCOk
barsUk	barsuCOk
Opus	opusOk
kopIl	kopilOk
posAd	posadOk
rundUk	runduCOk
ribAk	ribaCOk
naDEl	naDelOk
BedNAk	BedNaCOk
PervAC	PervaCOk
QelUdok	QeludoCOk
kolOk	koloCOk
ListOk	ListoCOk
pRIgorod	pRigorodOk
krugLAh	krugLahOk
krUg	kruQOk
otSEv	otSevOk
kablUk	kabluCOk
zAl	zalOk
jAkoR	jakoROk
tungUs	tungusOk
vOlok	voloCOk
VETer	VeTerOk
gUd	gudOk
xrAp	xrapOk
CERep	CeRepOk
kOl	kolOk
arIk	ariCOk
gruzoVIk	gruzoViCOk
vOjlok	vojloCOk
plAv	plavOk
xrapUn	xrapunOk
mArhal	marhalOk
motIL	motiLOk
obrUbok	obruboCOk
Ovod	ovodOk
glazOk	glazoCOk
klUb	klubOk
goLIk	goLiCOk
rogAC	rogaCOk
pREss	pRessOk
VECer	VeCerOk
hIp	hipOk
tOm	tomOk
QbAn	QbanOk
QEst	QestOk
lOb	lobOk
strUg	struQOk
oSInNik	oSinNiCOk
rusAk	rusaCOk
maxoVIk	maxoViCOk
tOrg	torQOk
Ostrov	ostrovOk
xoxOl	xoxolOk
kOMeL	koMeLOk
mrAk	mraCOk
zAm	zamOk
kuLOk	kuLeCOk
sLIp	sLipOk
jELNik	jeLNiCOk
jUr	jurOk
bahmAk	bahmaCOk
SErNik	SerNiCOk
slUx	sluhOk
bREd	bRedOk
platOk	platoCOk
burAk	buraCOk
pUtNik	putNiCOk
pLEn	pLenOk
PEst	PestOk
koheLOk	koheLeCOk
LOt	LetOk
ivNAk	ivNaCOk
jAm	jamOk
boCAg	boCaQOk
smoLAk	smoLaCOk
LedOk	LedoCOk
BelorUs	BelorusOk
paRIk	paRiCOk
VeCerOk	VeCeroCOk
bUr	burOk
vIbros	vibrosOk
sOboL	soboLOk
sAd	sadOk
zaHItNik	zaHitNiCOk
gRibOk	gRiboCOk
tUk	tuCOk
prostAk	prostaCOk
kOrhun	korhunOk
OpTik	opTiCOk
pLeMAnNik	pLeManNiCOk
vOlos	volosOk
mAsTer	masTerOk
batOg	batoQOk
gOlos	golosOk
romAn	romanOk
skOl	skolOk
staRIk	staRiCOk
gOrod	gorodOk
zUj	zujOk
brAt	bratOk
tOl	tolOk
pAn	panOk
Obux	obuhOk
kamIh	kamihOk
obrIv	obrivOk
kabAn	kabanOk
martIn	martinOk
ZOv	ZevOk
pRedbAnNik	pRedbanNiCOk
LEv	LevOk
kOn	konOk
sVEt	sVetOk
CEx	CehOk
sTIx	sTihOk
ZemLAk	ZemLaCOk
tolsTAk	tolsTaCOk
sapUn	sapunOk
maloLEtok	maloLetoCOk
tOr	torOk
fugAnok	fuganoCOk
kUr	kurOk
kRAk	kRaCOk
gOgoL	gogoLOk
kolpAk	kolpaCOk
rOt	rotOk
vOlk	volCOk
rubAnok	rubanoCOk
dIm	dimOk
golubOk	goluboCOk
vIQim	viQimOk
kolobOk	koloboCOk
kaLIn	kaLinOk
Us	usOk
luQOk	luQoCOk
nOMer	noMerOk
sTEBeL	sTeBeLOk
rOg	roQOk
NIz	NizOk
kONux	koNuhOk
molotOk	molotoCOk
poZOm	poZemOk
pOdpol	podpolOk
kOm	komOk
porohOk	porohoCOk
brOd	brodOk
PirOg	PiroQOk
plUg	pluQOk
laROk	laReCOk
plAC	plaCOk
VIs	VisOk
Ad	adOk
lAk	laCOk
okOlih	okolihOk
narOd	narodOk
LesoVIk	LesoViCOk
lUb	lubOk
dubOk	duboCOk
naCALNik	naCaLNiCOk
rAz	razOk
QOlob	QelobOk
bLIn	bLinOk
PervopUt	PervoputOk
suCOk	suCoCOk
sAk	saCOk
CeRepOk	CeRepoCOk
mNIx	mNihOk
hAr	harOk
ReMehOk	ReMehoCOk
poMIn	poMinOk
jesaUl	jesaulOk
podArok	podaroCOk
stAv	stavOk
xRAk	xRaCOk
naCIn	naCinOk
koldUn	koldunOk
gReBehOk	gReBehoCOk
sVistOk	sVistoCOk
tabAk	tabaCOk
gRIb	gRibOk
obREz	obRezOk
vaSiLOk	vaSiLeCOk
DinAMik	DinaMiCOk
kUm	kumOk
PeRenOs	PeRenosOk
dOk	doCOk
sAn	sanOk
NevOLNik	NevoLNiCOk
PERekRest	PeRekRestOk
bLinOk	bLinoCOk
ustUp	ustupOk
htRIx	htRihOk
xrapoVIk	xrapoViCOk
pRivAr	pRivarOk
QId	QidOk
oskOlok	oskoloCOk
ROv	RevOk
lUg	luQOk
naPOrstok	naPerstoCOk
upAd	upadOk
TeLOnok	TeLenoCOk
tUt	tutOk
vOr	vorOk
pRigOrok	pRigoroCOk
xOxot	xoxotOk
taLNIk	taLNiCOk
xAm	xamOk
podPOk	podPeCOk
batrAk	batraCOk
CelnOk	CelnoCOk
cVetNIk	cVetNiCOk
QeNIx	QeNihOk
mOL	moLOk
VAz	VazOk
krAt	kratOk
pOlog	poloQOk
rOm	romOk
osobNAk	osobNaCOk
hnurOk	hnuroCOk
koziROk	koziReCOk
prorOst	prorostOk
MehOk	MehoCOk
moskAL	moskaLOk
CulOk	CuloCOk
goRUn	goRunOk
tUz	tuzOk
jUt	jutOk
zApax	zapahOk
klAd	kladOk
bAs	basOk
pRIstup	pRistupOk
SIVer	SiVerOk
ogArok	ogaroCOk
fLIGeL	fLiGeLOk
otrOstok	otrostoCOk
vOjt	vojtOk
TesAk	TesaCOk
slIx	slihOk
bAk	baCOk
Obod	obodOk
vOz	vozOk
DEk	DeCOk
tOrmoz	tormozOk
kustArNik	kustarNiCOk
VerstAk	VerstaCOk
muQIk	muQiCOk
otrOg	otroQOk
pOros	porosOk
tagAn	taganOk
zvOn	zvonOk
LAx	LahOk
zrAk	zraCOk
skRIp	skRipOk
KIj	KijOk
hpAk	hpaCOk
REMez	ReMezOk
urOd	urodOk
kOt	kotOk
uhAn	uhanOk
pRijOmNik	pRijemNiCOk
kozLOnok	kozLenoCOk
hVEd	hVedOk
frAnk	franCOk
krAn	kranOk
dOm	domOk
lAd	ladOk
podrOst	podrostOk
kovAL	kovaLOk
puziROk	puziReCOk
otrUb	otrubOk
tUr	turOk
zakUt	zakutOk
dUh	duhOk
GEn	GenOk
kuhAk	kuhaCOk
pOd	podOk
rostOk	rostoCOk
opOr	oporOk
polukrUg	polukruQOk
CAs	CasOk
kogotOk	kogotoCOk
koREc	korCOk
adResOk	adResoCOk
pOt	potOk
morgUn	morgunOk
prAx	prahOk
DOr	DerOk
TenorOk	TenoroCOk
As	asOk
zvonOk	zvonoCOk
xodUn	xodunOk
cEp	cepOk
xoMAk	xoMaCOk
monastIR	monastiROk
klAss	klassOk
HUr	HurOk
TUk	TuCOk
RevUn	RevunOk
plAt	platOk
gOl	golOk
cVEt	cVetOk
strAnNik	stranNiCOk
CetVeRIk	CetVeRiCOk
CUb	CubOk
obrIvok	obrivoCOk
oREx	oRehOk
sNEg	sNeQOk
skOk	skoCOk
plaUn	plaunOk
BiRUC	BiRuCOk
bOb	bobOk
pOjas	pojasOk
pRisOs	pRisosOk
lOx	lohOk
nosOk	nosoCOk
rudNIk	rudNiCOk
stojAk	stojaCOk
RIs	RisOk
pRilAvok	pRilavoCOk
tOpoL	topoLOk
gOlod	golodOk
kRITik	kRiTiCOk
xolodOk	xolodoCOk
istOk	istoCOk
grOm	gromOk
rIQik	riQiCOk
SeRedNAk	SeRedNaCOk
bobIL	bobiLOk
ruBEQ	ruBeQOk
plAn	planOk
CesnOk	CesnoCOk
pREd	pRedOk
PIk	PiCOk
xOd	xodOk
PatAk	PataCOk
vIstRel	vistRelOk
oDOr	oDerOk
kolOn	kolonOk
tUPik	tuPiCOk
doVEsok	doVesoCOk
sLIv	sLivOk
staTIsTik	staTisTiCOk
pIl	pilOk
CerdAk	CerdaCOk
ogoNOk	ogoNeCOk
kVIt	kVitOk
QEmCug	QemCuQOk
pRivAl	pRivalOk
podLOt	podLetOk
pojasOk	pojasoCOk
mOst	mostOk
proSOlok	proSeloCOk
otTEnok	otTenoCOk
helOm	helomOk
blOk	bloCOk
sIn	sinOk
CebAk	CebaCOk
TIs	TisOk
LUk	LuCOk
Okrug	okruQOk
ostrOg	ostroQOk
CerpAk	CerpaCOk
majAk	majaCOk
tIl	tilOk
koTelOk	koTeloCOk
RukzAk	RukzaCOk
pIQ	piQOk
oxOtNik	oxotNiCOk
posLEdih	posLedihOk
vOin	voinOk
vImPel	vimPelOk
risAk	risaCOk
tOp	topOk
klobUk	klobuCOk
proUlok	prouloCOk
zAv	zavOk
ovrAg	ovraQOk
CObot	CebotOk
dosUg	dosuQOk
druQOk	druQoCOk
krIQ	kriQOk
kOvhik	kovhiCOk
kabAk	kabaCOk
CinOvNik	CinovNiCOk
gorhOk	gorhoCOk
SEv	SevOk
NEvod	NevodOk
ugoLOk	ugoLeCOk
CEtNik	CetNiCOk
pArus	parusOk
gOvor	govorOk
CAn	CanOk
PesOk	PesoCOk
bROx	bRehOk
anGelOk	anGeloCOk
gOd	godOk
zvUk	zvuCOk
obREzok	obRezoCOk
NedoMEr	NedoMerOk
tREPel	tRePelOk
Ar	arOk
zajEzd	zajezdOk
poSOlok	poSeloCOk
ulAn	ulanOk
pAs	pasOk
DEd	DedOk
pUp	pupOk
sVetLAk	sVetLaCOk
kLEVer	kLeVerOk
pOgReb	pogRebOk
VId	VidOk
sVeQAk	sVeQaCOk
motiLOk	motiLeCOk
mUCeNik	muCeNiCOk
bAnk	banCOk
mIs	misOk
PeReLOt	PeReLetOk
tovAr	tovarOk
bEr	berOk
bUBen	buBenOk
QIm	QimOk
kATer	kaTerOk
kUL	kuLOk
pOlk	polCOk
koTOl	koTelOk
MEx	MehOk
krOLik	kroLiCOk
rodNIk	rodNiCOk
oCOs	oCesOk
mUl	mulOk
trAns	transOk
sOn	sonOk
obnOs	obnosOk
brAk	braCOk
nasAd	nasadOk
bOt	botOk
mundhtUk	mundhtuCOk
hPeNOk	hPeNeCOk
dOn	donOk
DeNOk	DeNeCOk
vISev	viSevOk
soVEt	soVetOk
jAz	jazOk
stRigUn	stRigunOk
vrAg	vraQOk
LIst	ListOk
naQdAk	naQdaCOk
kUpol	kupolOk
uCeNIk	uCeNiCOk
xObot	xobotOk
trOn	tronOk
jagNOnok	jagNenoCOk
plavNIk	plavNiCOk
mosOl	mosolOk
podvorotNIk	podvorotNiCOk
obodOk	obodoCOk
naPILNik	naPiLNiCOk
gOn	gonOk
PEk	PeCOk
mAk	maCOk
gAz	gazOk
DORen	DeRenOk
AnGel	anGelOk
HIp	HipOk
cipLOnok	cipLenoCOk
SEt	SetOk
zOnTik	zonTiCOk
lOm	lomOk
pLasUn	pLasunOk
fAl	falOk
jAHik	jaHiCOk
LEMex	LeMehOk
CEk	CeCOk
tOn	tonOk
kostIL	kostiLOk
LedNIk	LedNiCOk
otQIm	otQimOk
OrDen	orDenOk
kalmIk	kalmiCOk
pOp	popOk
parNIk	parNiCOk
kohEL	koheLOk
fLUGer	fLuGerOk
lokotOk	lokotoCOk
stOg	stoQOk
brUs	brusOk
jAr	jarOk
Ud	udOk
rAd	radOk
kOFej	koFejOk
MOd	MedOk
HenOk	HenoCOk
sNImok	sNimoCOk
zUb	zubOk
Um	umOk
bodUn	bodunOk
kruQOk	kruQoCOk
sVIst	sVistOk
hEst	hestOk
podsOlnux	podsolnuhOk
hAx	hahOk
kosTOr	kosTerOk
topOr	toporOk
pUx	puhOk
hmAt	hmatOk
hnUr	hnurOk
koFEjNik	koFejNiCOk
poloVIk	poloViCOk
vAr	varOk
podorOQNik	podoroQNiCOk
poddOn	poddonOk
NedorOstok	NedorostoCOk
PeReLEsok	PeReLesoCOk
pRamougOLNik	pRamougoLNiCOk
cigAn	ciganOk
torFaNIk	torFaNiCOk
sNetOk	sNetoCOk
rAb	rabOk
posLEd	posLedOk
MEl	MelOk
xARius	xaRiusOk
CugUn	CugunOk
lOv	lovOk
kUsTik	kusTiCOk
boLheVIk	boLheViCOk
LIsTik	LisTiCOk
BEk	BeCOk
sosUn	sosunOk
trAs	trasOk
pUd	pudOk
gUl	gulOk
paLisAdNik	paLisadNiCOk
jazIk	jaziCOk
zakUtok	zakutoCOk
nastAvNik	nastavNiCOk
kAtih	katihOk
CIn	CinOk
anaLITik	anaLiTiCOk
dUb	dubOk
bodRAk	bodRaCOk
cEntr	centrOk
vOrot	vorotOk
pRirOst	pRirostOk
tReskUn	tReskunOk
BEs	BesOk
kArC	karCOk
komAr	komarOk
LePestOk	LePestoCOk
pAMatNik	paMatNiCOk
hMEL	hMeLOk
ihAk	ihaCOk
pastUx	pastuhOk
podvAl	podvalOk
podkUr	podkurOk
htIR	htiROk
nOrov	norovOk
sovOk	sovoCOk
podREz	podRezOk
skAt	skatOk
QelvAk	QelvaCOk
utOr	utorOk
jOQ	jeQOk
cVetOk	cVetoCOk
lopUx	lopuhOk
rAk	raCOk
mAx	mahOk
prUd	prudOk
SErp	SerpOk
srOdNik	srodNiCOk
prOps	propsOk
kREp	kRepOk
rabOtNik	rabotNiCOk
ULej	uLejOk
jarlIk	jarliCOk
tabUn	tabunOk
PESenNik	PeSenNiCOk
drOzd	drozdOk
naPItok	naPitoCOk
PeREdNik	PeRedNiCOk
ruCEj	ruCejOk
vIrost	virostOk
bAr	barOk
sLepIh	sLepihOk
sudAk	sudaCOk
bAh	bahOk
xoloDILNik	xoloDiLNiCOk
MiLOnok	MiLenoCOk
gvozdOk	gvozdoCOk
fOl	folOk
koCAn	koCanOk
motOk	motoCOk
kazAn	kazanOk
CeROd	CeRedOk
sLItok	sLitoCOk
MERin	MeRinOk
PIr	PirOk
bIk	biCOk
xvAt	xvatOk
sIr	sirOk
dostAtok	dostatoCOk
rOd	rodOk
prAzdNik	prazdNiCOk
kosAR	kosaROk
valUx	valuhOk
poluhUbok	poluhuboCOk
PeROd	PeRedOk
mahtAk	mahtaCOk
moRAk	moRaCOk
oblOm	oblomOk
hOk	hoCOk
PidQAk	PidQaCOk
glAd	gladOk
LesOk	LesoCOk
vIkup	vikupOk
lapotOk	lapotoCOk
lOgik	logiCOk
uZelOk	uZeloCOk
pAr	parOk
sTAg	sTaQOk
gusAk	gusaCOk
gUrt	gurtOk
kazAk	kazaCOk
pOl	polOk
TuFAk	TuFaCOk
NedoLIv	NedoLivOk
smIk	smiCOk
sVITer	sViTerOk
stanOk	stanoCOk
pAl	palOk
otDEl	otDelOk
skLIz	skLizOk
stOn	stonOk
tOk	toCOk
BEl	BelOk
komOk	komoCOk
malIh	malihOk
vlAx	vlahOk
CurbAk	CurbaCOk
poLAk	poLaCOk
hlIk	hliCOk
SiBiRAk	SiBiRaCOk
pRicVEtNik	pRicVetNiCOk
sAp	sapOk
poroQNAk	poroQNaCOk
Il	ilOk
katOk	katoCOk
gudOk	gudoCOk
iOn	ionOk
QivOt	QivotOk
PeNOk	PeNeCOk
kRUk	kRuCOk
COt	CetOk
porOg	poroQOk
vIRez	viRezOk
zVER	zVeROk
pAk	paCOk
kOzon	kozonOk
skRebOk	skReboCOk
naplAv	naplavOk
dubNAk	dubNaCOk
pokOjNik	pokojNiCOk
stAn	stanOk
KiSEL	KiSeLOk
rIk	riCOk
BEReg	BeReQOk
xREn	xRenOk
POs	PesOk
pRiREz	pRiRezOk
hIh	hihOk
sbOrNik	sborNiCOk
fArtuk	fartuCOk
srIv	srivOk
drUg	druQOk
QeReBOnok	QeReBenoCOk
sAxar	saxarOk
sPIl	sPilOk
NECet	NeCetOk
FILin	FiLinOk
koZOl	koZelOk
sojUzNik	sojuzNiCOk
bUk	buCOk
godoVIk	godoViCOk
CudAk	CudaCOk
sTEn	sTenOk
jUmor	jumorOk
tREn	tRenOk
koTOnok	koTenoCOk
rAtNik	ratNiCOk
sNeQOk	sNeQoCOk
lobAn	lobanOk
gorodOk	gorodoCOk
hARik	haRiCOk
klubOk	kluboCOk
sosNAk	sosNaCOk
pOloz	polozOk
koQUx	koQuhOk
uCAstok	uCastoCOk
kLOn	kLenOk
korOL	koroLOk
otrIv	otrivOk
kUb	kubOk
gnojNIk	gnojNiCOk
proTIvNik	proTivNiCOk
gUQ	guQOk
CIQ	CiQOk
oSOl	oSelOk
QOrnov	QernovOk
CernIh	CernihOk
soSEd	soSedOk
bUbLik	bubLiCOk
plAst	plastOk
VeTerOk	VeTeroCOk
LOd	LedOk
MeNheVIk	MeNheViCOk
grUz	gruzOk
ruhNIk	ruhNiCOk
kABeL	kaBeLOk
grAn	granOk
zatIlok	zatiloCOk
skovorOdNik	skovorodNiCOk
ReCNIk	ReCNiCOk
MirOn	MironOk
hahlIk	hahliCOk
bOh	bohOk
mOr	morOk
PeReUlok	PeReuloCOk
ugolOvNik	ugolovNiCOk
BitOk	BitoCOk
koNOk	koNeCOk
sOk	soCOk
sOlod	solodOk
uMOt	uMetOk
PiroQOk	PiroQoCOk
moxoVIk	moxoViCOk
paUk	pauCOk
lotOk	lotoCOk
mostOk	mostoCOk
grOh	grohOk
hepotOk	hepotoCOk
gAlstuk	galstuCOk
BIt	BitOk
vALs	vaLsOk
karavAj	karavajOk
zApad	zapadOk
jAstReb	jastRebOk
Obraz	obrazOk
podPIl	podPilOk
gOnor	gonorOk
lAz	lazOk
BeReQOk	BeReQoCOk
noMerOk	noMeroCOk
jAd	jadOk
slAd	sladOk
noVIk	noViCOk
vOron	voronOk
sOm	somOk
QIr	QirOk
kREm	kRemOk
rOdstVenNik	rodstVenNiCOk
TETeRev	TeTeRevOk
COs	CesOk
vOrox	vorohOk
snOp	snopOk
dOQDik	doQDiCOk
gRIFeL	gRiFeLOk
otpAd	otpadOk
QUk	QuCOk
strAx	strahOk
GeNETik	GeNeTiCOk
sVistUn	sVistunOk
obSEv	obSevOk
sIC	siCOk
paroVIk	paroViCOk
broNeVIk	broNeViCOk
kAp	kapOk
rAzum	razumOk
UQ	uQOk
kREst	kRestOk
zakoUlok	zakouloCOk
polzUn	polzunOk
otvOd	otvodOk
TERem	TeRemOk
provOd	provodOk
gRIVenNik	gRiVenNiCOk
oblOmok	oblomoCOk
pOst	postOk
pRANik	pRaNiCOk
oBEd	oBedOk
tAl	talOk
nOs	nosOk
uzOr	uzorOk
burlAk	burlaCOk
ostAtok	ostatoCOk
kULt	kuLtOk
bUt	butOk
bugOr	bugorOk
ogrIzok	ogrizoCOk
gAd	gadOk
htIk	htiCOk
prigUn	prigunOk
MUL	MuLOk
xMEL	xMeLOk
mArh	marhOk
gubAn	gubanOk
ugOdNik	ugodNiCOk
pRiVEs	pRiVesOk
vOzdux	vozduhOk
boroVIk	boroViCOk
bUj	bujOk
poroSOnok	poroSenoCOk
REz	RezOk
zUd	zudOk
gorbOk	gorboCOk
pRiklAd	pRikladOk
podCAl	podCalOk
Uk	uCOk
maLInNik	maLinNiCOk
Omut	omutOk
postAv	postavOk
kuLIC	kuLiCOk
CetVertAk	CetVertaCOk
skOt	skotOk
sUk	suCOk
puzAn	puzanOk
xOR	xoROk
xrAm	xramOk
sMehOk	sMehoCOk
opOj	opojOk
DjAk	DjaCOk
bahlIk	bahliCOk
otrIvok	otrivoCOk
kOk	koCOk
SiLEn	SiLenOk
lOg	loQOk
vOj	vojOk
struCOk	struCoCOk
pusTAk	pusTaCOk
kAnt	kantOk
CerVAk	CerVaCOk
DidAkTik	DidakTiCOk
jAs	jasOk
kloCOk	kloCoCOk
podVEs	podVesOk
ostrovOk	ostrovoCOk
SeLEn	SeLenOk
glOt	glotOk
sLOt	sLetOk
AdRes	adResOk
LubOvNik	LubovNiCOk
CAl	CalOk
mAt	matOk
grAFik	graFiCOk
znAk	znaCOk
VEs	VesOk
xArC	xarCOk
vIvod	vivodOk
zastUpNik	zastupNiCOk
ubOr	uborOk
uTUg	uTuQOk
krOt	krotOk
bARin	baRinOk
kvAs	kvasOk
BeLAk	BeLaCOk
VIxoR	VixoROk
golIh	golihOk
balIk	baliCOk
kREnDeL	kRenDeLOk
NedoVEs	NedoVesOk
tAt	tatOk
bIt	bitOk
burAv	buravOk
barAn	baranOk
PIsaR	PisaROk
kUzov	kuzovOk
VERes	VeResOk
raznoVEs	raznoVesOk
SItNik	SitNiCOk
mOt	motOk
poLITik	poLiTiCOk
CasOk	CasoCOk
stOlb	stolbOk
pLUs	pLusOk
kOvRik	kovRiCOk
pAxaR	paxaROk
glAs	glasOk
RisUnok	RisunoCOk
FiAl	FialOk
strOp	stropOk
QigAn	QiganOk
xOlod	xolodOk
kolxOz	kolxozOk
VenOk	VenoCOk
poCIn	poCinOk
htABeL	htaBeLOk
mOl	molOk
misOk	misoCOk
hAg	haQOk
razOk	razoCOk
palAc	palacOk
loskutOk	loskutoCOk
otREz	otRezOk
HEgoL	HegoLOk
ohEjNik	ohejNiCOk
pOsox	posohOk
pOrt	portOk
PirOn	PironOk
laFItNik	laFitNiCOk
spOr	sporOk
ObruC	obruCOk
LOn	LenOk
VixOr	VixorOk
podOg	podoQOk
bojeVIk	bojeViCOk
PetUx	PetuhOk
iznOs	iznosOk
bazAr	bazarOk
hIk	hiCOk
novoSOl	novoSelOk
voQAk	voQaCOk
brusOk	brusoCOk
poLigrAf	poLigrafOk
lOt	lotOk
puxoVIk	puxoViCOk
BIC	BiCOk
podnOs	podnosOk
pAx	pahOk
kUCer	kuCerOk
hOpot	hepotOk
raspAd	raspadOk
Ant	antOk
kOh	kohOk
sUd	sudOk
makSIm	makSimOk
UgoL	ugoLOk
rOv	rovOk
grAC	graCOk
goLEc	golCOk
MetaFIZik	MetaFiZiCOk
koQAn	koQanOk
rOst	rostOk
zaVitOk	zaVitoCOk
dNevNIk	dNevNiCOk
pUl	pulOk
puzIR	puziROk
xAn	xanOk
bagOr	bagorOk
gOrb	gorbOk
sMEx	sMehOk
bOg	boQOk
mOlot	molotOk
vAtNik	vatNiCOk
dOlg	dolQOk
mOx	mohOk
klIk	kliCOk
bOr	borOk
kOCet	koCetOk
bArMen	barMenOk
poQAr	poQarOk
sokolOk	sokoloCOk
pRaMIk	pRaMiCOk
flAg	flaQOk
xLEb	xLebOk
BeRezNAk	BeRezNaCOk
zavorOt	zavorotOk
gAk	gaCOk
LizUn	LizunOk
LUd	LudOk
skvozNAk	skvozNaCOk
svAt	svatOk
kOlos	kolosOk
sREz	sRezOk
polukustArNik	polukustarNiCOk
vorotNIk	vorotNiCOk
gOgot	gogotOk
kUs	kusOk
hrAm	hramOk
NedoUzdok	NedouzdoCOk
SurtUk	SurtuCOk
UgoLNik	ugoLNiCOk
HaVEL	HaVeLOk
poCOt	poCetOk
bOndaR	bondaROk
lAtNik	latNiCOk
vUz	vuzOk
trUt	trutOk
bOrov	borovOk
vAl	valOk
ujEzd	ujezdOk
MexANik	MexaNiCOk
VEnZeL	VenZeLOk
poRAdok	poRadoCOk
stOroQ	storoQOk
zarOdih	zarodihOk
toREc	torCOk
xrUst	xrustOk
pOvod	povodOk
nAr	narOk
koNjAk	koNjaCOk
xUtor	xutorOk
pomOHNik	pomoHNiCOk
kREstNik	kRestNiCOk
kOlob	kolobOk
dvojNIk	dvojNiCOk
sLedOk	sLedoCOk
barIh	barihOk
ugolOk	ugoloCOk
Ugol	ugolOk
kRuCOk	kRuCoCOk
boCOnok	boConoCOk
sVOrtok	sVertoCOk
VejerOk	VejeroCOk
HOkot	HekotOk
harAp	harapOk
rukAv	rukavOk
VEk	VeCOk
LAd	LadOk
durAk	duraCOk
TOs	TesOk
sorAtNik	soratNiCOk
kUt	kutOk
AnKer	anKerOk
TIGeL	TiGeLOk
gREx	gRehOk
arMAk	arMaCOk
VEjer	VejerOk
sudOk	sudoCOk
tIn	tinOk
tvorOg	tvoroQOk
droboVIk	droboViCOk
podsAk	podsaCOk
gorbIL	gorbiLOk
zAd	zadOk
QAr	QarOk
mAz	mazOk
kLUC	kLuCOk
srOst	srostOk
xRipUn	xRipunOk
ReBOnok	ReBenoCOk
HOlk	HelCOk
FiTIL	FiTiLOk
kolxOzNik	kolxozNiCOk
kLOv	kLevOk
otREzok	otRezoCOk
hOv	hovOk
COrt	CertOk
kRAQ	kRaQOk
dAr	darOk
trUd	trudOk
ruCejOk	ruCejeCOk
pOvar	povarOk
podrOstok	podrostoCOk
markSIst	markSistOk
koSAk	koSaCOk
vOd	vodOk
PEPel	PePelOk
oCAg	oCaQOk
gorOx	gorohOk
otbrOs	otbrosOk
voroBEj	voroBejOk
gorbUn	gorbunOk
gruzdOk	gruzdoCOk
stUk	stuCOk
LIhek	LiheCOk
kadIk	kadiCOk
stAQ	staQOk
jOrh	jerhOk
CAjNik	CajNiCOk
nOQik	noQiCOk
lUk	luCOk
vOl	volOk
ponomAR	ponomaROk
SinTETik	SinTeTiCOk
Ost	ostOk
jEr	jerOk
kuZEn	kuZenOk
tarAn	taranOk
burundUk	burunduCOk
tReugOLNik	tReugoLNiCOk
bAz	bazOk
xrOm	xromOk
riCAg	riCaQOk
kOziR	koziROk
VisOk	VisoCOk
golosOk	golosoCOk
kubAR	kubaROk
golovAn	golovAnCik
balagAn	balagAnCik
jUr	jUrCik
klApan	klApanCik
navOj	navOjCik
bAr	bArCik
ZipUn	ZipUnCik
trakTIr	trakTIrCik
SirOp	SirOpCik
nagAn	nagAnCik
zAl	zALCik
bOb	bObCik
ustAv	ustAvCik
graQdaNIn	graQdaNInCik
mandaRIn	mandaRInCik
klOp	klOpCik
kabAn	kabAnCik
razgOn	razgOnCik
staDiOn	staDiOnCik
inTeRjEr	inTeRjErCik
BEl	BELCik
kUr	kUrCik
kankAn	kankAnCik
LimOn	LimOnCik
FestOn	FestOnCik
sAn	sAnCik
probOj	probOjCik
izgIb	izgIbCik
oFicEr	oFicErCik
kavaLEr	kavaLErCik
kUb	kUbCik
baRitOn	baRitOnCik
SignAl	SignALCik
bukSIr	bukSIrCik
kOkon	kOkonCik
rukAv	rukAvCik
RiDiKUL	RiDiKULCik
adRenaLIn	adRenaLInCik
voDeVIL	voDeVILCik
zasOv	zasOvCik
htOf	htOfCik
ovAl	ovALCik
plavUn	plavUnCik
lOv	lOvCik
sOkol	sOkoLCik
bLIn	bLInCik
kooPeraTIv	kooPeraTIvCik
protokOl	protokOLCik
CugUn	CugUnCik
podOl	podOLCik
kosogOr	kosogOrCik
aZAm	aZAmCik
kRikUn	kRikUnCik
hOv	hOvCik
tolkUn	tolkUnCik
dragUn	dragUnCik
zaslOn	zaslOnCik
topCAn	topCAnCik
arAp	arApCik
bostOn	bostOnCik
trampLIn	trampLInCik
CIn	CInCik
tarakAn	tarakAnCik
MEl	MELCik
orgAn	orgAnCik
kUn	kUnCik
skorPiOn	skorPiOnCik
garNitUr	garNitUrCik
CUb	CUbCik
portFEL	portFELCik
butOn	butOnCik
vOron	vOronCik
karmAn	karmAnCik
giPUr	giPUrCik
malaxAj	malaxAjCik
KilogrAmm	KilogrAmmCik
KeroSIn	KeroSInCik
futbOl	futbOLCik
SimptOm	SimptOmCik
abaQUr	abaQUrCik
tREn	tREnCik
kuvhIn	kuvhInCik
razgovOr	razgovOrCik
cirkuLAr	cirkuLArCik
XeruVIm	XeruVImCik
parOm	parOmCik
MirOn	MirOnCik
kaLIn	kaLInCik
hkAf	hkAfCik
iOn	iOnCik
kaRjEr	kaRjErCik
kuMIr	kuMIrCik
sarAj	sarAjCik
borDEL	borDELCik
burQUj	burQUjCik
arAb	arAbCik
xuLigAn	xuLigAnCik
sUp	sUpCik
kAp	kApCik
HIp	HIpCik
koMissAr	koMissArCik
tolstUn	tolstUnCik
FinAl	FinALCik
tumAn	tumAnCik
grAmm	grAmmCik
stoLAr	stoLArCik
maLCugAn	maLCugAnCik
maTeRiAl	maTeRiALCik
prigUn	prigUnCik
bOn	bOnCik
prokOp	prokOpCik
BEk	BEkCik
bAj	bAjCik
sosUn	sosUnCik
provAl	provALCik
tonNEL	tonNELCik
kOlokol	kOlokoLCik
GektAr	GektArCik
srUb	srUbCik
pompOn	pompOnCik
HelkUn	HelkUnCik
tatARin	tatARinCik
lokomoTIv	lokomoTIvCik
sTEn	sTEnCik
dUb	dUbCik
muraVEj	muraVEjCik
fuQEr	fuQErCik
otDEl	otDELCik
TuLpAn	TuLpAnCik
portSigAr	portSigArCik
izjAn	izjAnCik
fOtoaLbOm	fotoaLbOmCik
harabAn	harabAnCik
TeLeVIzor	TeLeVIzorCik
PeRerIv	PeRerIvCik
ReQIm	ReQImCik
ekZempLAr	ekZempLArCik
hturvAl	hturvALCik
vzrIv	vzrIvCik
bazAr	bazArCik
LimAn	LimAnCik
kagAn	kagAnCik
VicmunDIr	VicmunDIrCik
vagOn	vagOnCik
hPiOn	hPiOnCik
prokOl	prokOLCik
LizUn	LizUnCik
borDUr	borDUrCik
LimuZIn	LimuZInCik
naftaLIn	naftaLInCik
staRikAn	staRikAnCik
buLjOn	buLjOnCik
tulUp	tulUpCik
PiQOn	PiQOnCik
koQAn	koQAnCik
pokOj	pokOjCik
poluhtOf	poluhtOfCik
pRiMEr	pRiMErCik
balaxOn	balaxOnCik
VixOr	VixOrCik
BiplAn	BiplAnCik
grammofOn	grammofOnCik
igrUn	igrUnCik
kapkAn	kapkAnCik
pacAn	pacAnCik
FiLiAl	FiLiALCik
rOzan	rOzanCik
stOl	stOLCik
barOn	barOnCik
GeNerAl	GeNerALCik
FiLEj	FiLEjCik
arXIv	arXIvCik
pRigOn	pRigOnCik
fazAn	fazAnCik
gRifOn	gRifOnCik
pSevdoNIm	pSevdoNImCik
MIr	MIrCik
gospoDIn	gospoDInCik
arhIn	arhInCik
vamPIr	vamPIrCik
zakOn	zakOnCik
maNiKUr	maNiKUrCik
tagAn	tagAnCik
skakUn	skakUnCik
hifoNjEr	hifoNjErCik
kokaIn	kokaInCik
borQOm	borQOmCik
fAl	fALCik
burUn	burUnCik
plafOn	plafOnCik
eLektromotOr	eLektromotOrCik
PikAp	PikApCik
zagovOr	zagovOrCik
fOn	fOnCik
magaZIn	magaZInCik
DeLFIn	DeLFInCik
jevREj	jevREjCik
halmAn	halmAnCik
uklOn	uklOnCik
drakOn	drakOnCik
vokzAl	vokzALCik
AnGel	AnGeLCik
karavAj	karavAjCik
zagOn	zagOnCik
aeroplAn	aeroplAnCik
rulOn	rulOnCik
uzOr	uzOrCik
QetOn	QetOnCik
maLAr	maLArCik
kosTUm	kosTUmCik
baReLjEf	baReLjEfCik
BegUn	BegUnCik
skandAl	skandALCik
kamzOl	kamzOLCik
TiUn	TiUnCik
SezOn	SezOnCik
tampOn	tampOnCik
stAn	stAnCik
uvAl	uvALCik
ehelOn	ehelOnCik
konovAl	konovALCik
MikrofOn	MikrofOnCik
bokAl	bokALCik
polupodvAl	polupodvALCik
TIp	TIpCik
panSiOn	panSiOnCik
bAl	bALCik
buduAr	buduArCik
DeTekTIv	DeTekTIvCik
NejtrOn	NejtrOnCik
LedokOl	LedokOLCik
tarAn	tarAnCik
VenTiLAtor	VenTiLAtorCik
suslOn	suslOnCik
nadrIv	nadrIvCik
popugAj	popugAjCik
ambAr	ambArCik
PingVIn	PingVInCik
bajAn	bajAnCik
udAr	udArCik
arkAn	arkAnCik
dvOr	dvOrCik
stAv	stAvCik
kahtAn	kahtAnCik
garDerOb	garDerObCik
snOp	snOpCik
samogOn	samogOnCik
dOllar	dOllarCik
krAj	krAjCik
galUn	galUnCik
saxaRIn	saxaRInCik
xoxotUn	xoxotUnCik
osmAn	osmAnCik
krAn	krAnCik
KIL	KILCik
sOn	sOnCik
martIn	martInCik
bOr	bOrCik
sarafAn	sarafAnCik
GEn	GEnCik
kartOn	kartOnCik
kanOn	kanOnCik
pogOn	pogOnCik
PistOn	PistOnCik
bugOr	bugOrCik
zaQIm	zaQImCik
BenZIn	BenZInCik
balkOn	balkOnCik
CekAn	CekAnCik
DiplOm	DiplOmCik
barabAn	barabAnCik
asPiRIn	asPiRInCik
zabOr	zabOrCik
LIf	LIfCik
kUL	kULCik
kaMIn	kaMInCik
talOn	talOnCik
burAv	burAvCik
VjUn	VjUnCik
majdAn	majdAnCik
barxAn	barxAnCik
CastokOl	CastokOLCik
Ar	ArCik
sbOr	sbOrCik
burAn	burAnCik
gorbUn	gorbUnCik
salOp	salOpCik
LekSikOn	LekSikOnCik
PivovAr	PivovArCik
kurgAn	kurgAnCik
fontAn	fontAnCik
sazAn	sazAnCik
poQAr	poQArCik
pAn	pAnCik
kupOn	kupOnCik
kOn	kOnCik
batOn	batOnCik
gastronOm	gastronOmCik
narzAn	narzAnCik
kvartAl	kvartALCik
komBiNezOn	komBiNezOnCik
juBiLEj	juBiLEjCik
vazOn	vazOnCik
plAn	plAnCik
huhUn	huhUnCik
hablOn	hablOnCik
amUr	amUrCik
baLzaMIn	baLzaMInCik
romAn	romAnCik
narIv	narIvCik
tabUn	tabUnCik
atamAn	atamAnCik
razDEl	razDELCik
salOn	salOnCik
kanAl	kanALCik
muZEj	muZEjCik
munDIr	munDIrCik
duxAn	duxAnCik
gaREm	gaREmCik
volAn	volAnCik
QurnAl	QurnALCik
tOm	tOmCik
flakOn	flakOnCik
zazOr	zazOrCik
VesTiBUL	VesTiBULCik
analOj	analOjCik
tOn	tOnCik
rassTegAj	rassTegAjCik
lOkon	lOkonCik
LEv	LEvCik
voroBEj	voroBEjCik
eVEn	eVEnCik
lUb	lUbCik
pOgReb	pOgRebCik
PjeDestAl	PjeDestALCik
burxAn	burxAnCik
valUn	valUnCik
naLIm	naLImCik
ruBIn	ruBInCik
iDeAl	iDeALCik
VitaMIn	VitaMInCik
poprigUn	poprigUnCik
baldaXIn	baldaXInCik
sIr	sIrCik
krOj	krOjCik
obrIv	obrIvCik
baRjEr	baRjErCik
bataLjOn	bataLjOnCik
pRibOr	pRibOrCik
vOl	vOLCik
kazAn	kazAnCik
CAn	CAnCik
dQejrAn	dQejrAnCik
makSIm	makSImCik
vOr	vOrCik
BidOn	BidOnCik
ustUp	ustUpCik
ReZervuAr	ReZervuArCik
kaPitAl	kaPitALCik
hrAm	hrAmCik
kOl	kOLCik
koRidOr	koRidOrCik
tramvAj	tramvAjCik
hurUp	hurUpCik
PikOn	PikOnCik
graFIn	graFInCik
dOl	dOLCik
kazaKIn	kazaKInCik
pRitOn	pRitOnCik
RevoLVEr	RevoLVErCik
poklOn	poklOnCik
banAn	banAnCik
koCAn	koCAnCik
udAv	udAvCik
CemodAn	CemodAnCik
kLIn	kLInCik
baUl	baULCik
vulkAn	vulkAnCik
blonDIn	blonDInCik
istukAn	istukAnCik
fasOn	fasOnCik
bUr	bUrCik
MezoNIn	MezoNInCik
paTefOn	paTefOnCik
CistogAn	CistogAnCik
patrOn	patrOnCik
QargOn	QargOnCik
DiktofOn	DiktofOnCik
proLIv	proLIvCik
pRiHEp	pRiHEpCik
AvtofurgOn	avtofurgOnCik
kalambUr	kalambUrCik
rajOn	rajOnCik
gruZIn	gruZInCik
majOr	majOrCik
gonorAr	gonorArCik
karaBIn	karaBInCik
stUl	stULCik
PenAl	PenALCik
xLEb	xLEbCik
govorUn	govorUnCik
zUb	zUbCik
kovAL	kovALCik
koldUn	koldUnCik
CulAn	CulAnCik
XitOn	XitOnCik
avtomoBIL	avtomoBILCik
SifOn	SifOnCik
krAp	krApCik
masSIv	masSIvCik
tUr	tUrCik
oDekolOn	oDekolOnCik
garNIr	garNIrCik
RestorAn	RestorAnCik
gOl	gOLCik
bolvAn	bolvAnCik
oVIn	oVInCik
otvAl	otvALCik
GerOj	GerOjCik
kRIn	kRInCik
vAl	vALCik
ekrAn	ekrAnCik
TeLefOn	TeLefOnCik
dogovOr	dogovOrCik
punkTIr	punkTIrCik
bUBen	bUBenCik
aPeLSIn	aPeLSInCik
MedaLjOn	MedaLjOnCik
motOr	motOrCik
voLjEr	voLjErCik
zatOn	zatOnCik
Il	ILCik
furgOn	furgOnCik
poMidOr	poMidOrCik
kaftAn	kaftAnCik
dOn	dOnCik
QulAn	QulAnCik
pogrOm	pogrOmCik
LiBerAl	LiBerALCik
rOv	rOvCik
nabOr	nabOrCik
mAj	mAjCik
TirAn	TirAnCik
bagOr	bagOrCik
sostAv	sostAvCik
basSEjn	basSEjnCik
rAj	rAjCik
PerrOn	PerrOnCik
pRiLIv	pRiLIvCik
pRiPEv	pRiPEvCik
CurbAn	CurbAnCik
korOL	korOLCik
zapOr	zapOrCik
harkUn	harkUnCik
kaPuhOn	kaPuhOnCik
tambUr	tambUrCik
krokoDIl	krokoDILCik
KeFIr	KeFIrCik
bOrov	bOrovCik
barAn	barAnCik
gazOn	gazOnCik
FeLjetOn	FeLjetOnCik
rassOl	rassOLCik
ukrOp	ukrOpCik
PeRevAl	PeRevALCik
PioNEr	PioNErCik
gOn	gOnCik
kaPitAn	kaPitAnCik
soloVEj	soloVEjCik
buxgAlTer	buxgAlTerCik
PenSiOn	PenSiOnCik
rAtaj	rAtajCik
jAl	jALCik
kAl	kALCik
gOvor	gOvorCik
aLbOm	aLbOmCik
probOr	probOrCik
sorTIr	sorTIrCik
lAn	lAnCik
saksaUl	saksaULCik
MilLiOn	MilLiOnCik
LEn	LEnCik
hUm	hUmCik
puzAn	puzAnCik
samovAr	samovArCik
vOj	vOjCik
goBeLEn	goBeLEnCik
buLvAr	buLvArCik
gornostAj	gornostAjCik
kotlovAn	kotlovAnCik
hugAj	hugAjCik
jEr	jErCik
kaplUn	kaplUnCik
razMEr	razMErCik
magNitofOn	magNitofOnCik
iZUm	iZUmCik
kokTEjL	kokTEjLCik
ballOn	ballOnCik
akkorDeOn	akkorDeOnCik
galOp	galOpCik
parTizAn	parTizAnCik
okOp	okOpCik
rOm	rOmCik
suVeNIr	suVeNIrCik
tOr	tOrCik
CexOl	CexOLCik
kolLekTIv	kolLekTIvCik
sultAn	sultAnCik
LEj	LEjCik
sugrOb	sugrObCik
alAn	alAnCik
KinQAl	KinQALCik
baLzAm	baLzAmCik
pocelUj	pocelUjCik
lobAn	lobAnCik
tovAr	tovArCik
DivAn	DivAnCik
vaLidOl	vaLidOLCik
kaZiMIr	kaZiMIrCik
oTEL	oTELCik
grAf	grAfCik
podvAl	podvALCik
rojAL	rojALCik
DergUn	DergUnCik
garpUn	garpUnCik
pAl	pALCik
kReOl	kReOLCik
trotuAr	trotuArCik
futLAr	futLArCik
stakAn	stakAnCik
aerodrOm	aerodrOmCik
gusAr	gusArCik
komanDIr	komanDIrCik
pRigovOr	pRigovOrCik
paViLjOn	paViLjOnCik
xlOp	xlOpCik
zaLIv	zaLIvCik
QbAn	QbAnCik
Idol	IdoLCik
dOktor	dOktorCik
tarbagAn	tarbagAnCik
frontOn	frontOnCik
moTIv	moTIvCik
grAb	grAbCik
taLismAn	taLismAnCik
ukOl	ukOLCik
sustAv	sustAvCik
hArf	hArFik
poluvAl	poluvALik
romAn	romANik
kaPitaLIst	kaPitaLIsTik
hUst	hUsTik
kuPEc	kup'Cik
pLUH	pLUHik
rUL	rULik
frAnt	frAnTik
xvOrost	xvOrosTik
murAh	murAhik
tOL	tOLik
HIt	HITik
xlOPec	xlOpCik
bOndaR	bOndaRik
bOrH	bOrHik
kOl	kOLik
akMeIst	akMeIsTik
QeltopUz	QeltopUZik
fonAR	fonARik
RejEstr	RejEstRik
BeGemOt	BeGemOTik
rOd	rODik
apOstol	apOstoLik
kLEr	kLERik
nAr	nARik
QiVEc	Qiv'Cik
rOm	rOMik
kOrm	kOrMik
hUt	hUTik
lOv	lOVik
pLAQ	pLAQik
maLEc	mALCik
prUt	prUTik
plAst	plAsTik
xAn	xANik
tkAC	tkACik
zakAZec	zakAzCik
vaLEt	vaLETik
BeLEc	BELCik
kLUC	kLUCik
LuBIMec	LuBImCik
hAr	hARik
donOs	donOSik
MAC	MACik
inQeNEr	inQeNERik
stAVec	stAvCik
gRIb	gRIBik
oROl	OrLik
brAt	brATik
kOrQ	kOrQik
zAl	zALik
hafrAn	hafrANik
abbAt	abbATik
dOQD	dOQDik
hpagAt	hpagATik
loVEc	lov'Cik
gvOzD	gvOzDik
SekREt	SekRETik
komOd	komODik
krAb	krABik
VeNEd	VeNEDik
halAh	halAhik
lOb	lOBik
parovOz	parovOZik
plAH	plAHik
gOrn	gOrNik
mOnokRistAll	monokRistAlLik
tUn	tUNik
pULt	pULTik
plOt	plOTik
kUt	kUTik
trUs	trUSik
MEl	MELik
gREBeN	gREBeNik
plakAt	plakATik
fAnt	fAnTik
karapUz	karapUZik
xLUst	xLUsTik
kovAL	kovALik
KIL	KILik
rOmb	rOmBik
dokuMEnt	dokuMEnTik
salOn	salONik
aRistOn	aRistONik
mAvr	mAvRik
xOlm	xOlMik
artRIt	artRITik
MedVED	MedVEDik
ornAMent	ornAMenTik
rAz	rAZik
kAl	kALik
htAmp	htAmPik
vOlos	vOloSik
pRiVEt	pRiVETik
bRilLiAnt	bRilLiAnTik
LEv	LEVik
gOt	gOTik
kostIL	kostILik
imaQiNIst	imaQiNIsTik
pRedMEt	pRedMETik
trOp	trOPik
buFEt	buFETik
LIs	LISik
CinAr	CinARik
anarXIst	anarXIsTik
Us	USik
krasAVec	krasAvCik
PervoproxODec	PervoproxOdCik
QEst	QEsTik
topOr	topORik
pALec	pA'LCik
ReZEc	Rez'Cik
jAl	jALik
sIC	sICik
Ort	OrTik
oFicEr	oFicERik
xOlst	xOlsTik
sUPec	sUpCik
bAs	bASik
karNIz	karNIZik
jAs	jASik
kohmAr	kohmARik
muzikAnt	muzikAnTik
KIj	KIjjik
sTekloplAst	sTekloplAsTik
hTIft	hTIfTik
rasskAZec	rasskAzCik
sKeLEt	sKeLETik
bOlt	bOlTik
vOjt	vOjTik
PeRIod	PeRIoDik
UQas	UQaSik
xOd	xODik
nOs	nOSik
sUdaR	sUdaRik
NEMec	NEmCik
HiPEc	Hip'Cik
buxARec	buxArCik
sAd	sADik
UQ	UQik
kUst	kUsTik
gOl	gOLik
koMissAr	koMissARik
CePEc	Cep'Cik
pUd	pUDik
DiaBEt	DiaBETik
hTEjn	hTEjNik
obraZEc	obraz'Cik
MindAL	MindALik
plAv	plAVik
RItor	RItoRik
kAtaL	kAtaLik
PErst	PErsTik
MEtod	MEtoDik
faLcEt	faLcETik
CLEn	CLENik
CUb	CUBik
iDiOt	iDiOTik
gimnaZIst	gimnaZIsTik
kOm	kOMik
buhlAt	buhlATik
kUrd	kUrDik
Ar	ARik
hLUp	hLUPik
xAz	xAZik
kLIr	kLIRik
rOt	rOTik
zUbr	zUbRik
sVEt	sVETik
kvadrAt	kvadrATik
avtOl	avtOLik
morOz	morOZik
zvOn	zvONik
drOt	drOTik
otRAd	otRADik
fOrs	fOrSik
golAvL	golAvLik
pAn	pANik
doMEn	doMENik
pOp	pOPik
glAd	glADik
Opt	OpTik
tAl	tALik
kUr	kURik
kaLIn	kaLINik
zavOd	zavODik
VerbLUd	VerbLUDik
PistoLEt	PistoLETik
matrAs	matrASik
majdAn	majdANik
mOps	mOpSik
SEVer	SEVeRik
kosAR	kosARik
sojUz	sojUZik
hrAm	hrAMik
SinOd	SinODik
MEtr	MEtRik
eTUd	eTUDik
zUb	zUBik
PErh	PErhik
SEjm	SEjMik
parahUt	parahUTik
sakvojAQ	sakvojAQik
gOd	gODik
pOrt	pOrTik
kLAp	kLAPik
zakOn	zakONik
kAdr	kAdRik
alkogOL	alkogOLik
kompOt	kompOTik
GEn	GENik
LiLipUt	LiLipUTik
logIst	logIsTik
tOn	tONik
futuRIst	futuRIsTik
DIskant	DIskanTik
dUb	dUBik
kOn	kONik
LIst	LIsTik
altAR	altARik
naVEs	naVESik
kaBiNEt	kaBiNETik
VAz	VAZik
aNekdOTec	aNekdOtCik
pUnkt	pUnkTik
bOrt	bOrTik
MetAll	MetAlLik
trAp	trAPik
mArs	mArSik
anAtom	anAtoMik
plAt	plATik
mAtC	mAtCik
kUL	kULik
LejTenAnt	LejTenAnTik
xMEL	xMELik
rAnt	rAnTik
kOrn	kOrNik
CIQ	CIQik
kanAt	kanATik
gonCAr	gonCARik
mUQ	mUQik
kUn	kUNik
paKEt	paKETik
kLEH	kLEHik
prUd	prUDik
VId	VIDik
pUtC	pUtCik
toREc	tor'Cik
zOnt	zOnTik
DEd	DEDik
dOm	dOMik
bAz	bAZik
koVOr	kOvRik
ciLIndr	ciLIndRik
salAt	salATik
ogorOd	ogorODik
lAd	lADik
sAz	sAZik
lAst	lAsTik
sVIst	sVIsTik
kOt	kOTik
pUnh	pUnhik
rasskAz	rasskAZik
kUrs	kUrSik
izumrUd	izumrUDik
jAZ	jAZik
QId	QIDik
rOss	rOsSik
koREc	kor'Cik
TIp	TIPik
DiagnOst	DiagnOsTik
rogAC	rogACik
vOrot	vOroTik
xlOp	xlOPik
poEt	poETik
ruBEc	rub'Cik
orKEstr	orKEstRik
tREn	tRENik
nUL	nULik
fAl	fALik
REkrut	REkruTik
Ass	AsSik
cEp	cEPik
katOd	katODik
goluBEc	golub'Cik
karandAh	karandAhik
plOd	plODik
BUst	BUsTik
MIm	MIMik
hmAt	hmATik
pAr	pARik
CAn	CANik
buTerbrOd	buTerbrODik
prUs	prUSik
pAkLen	pAkLeNik
mUl	mULik
almAz	almAZik
kOks	kOkSik
jAr	jARik
pIQ	pIQik
urOd	urODik
nOQ	nOQik
BEl	BELik
oLEN	oLENik
tolkAC	tolkACik
xrAm	xrAMik
QaKEt	QaKETik
QeReBEc	QeReb'Cik
maNiFEst	maNiFEsTik
konVErt	konVErTik
pAz	pAZik
tUr	tURik
stvOl	stvOLik
zOv	zOVik
gUQ	gUQik
komAr	komARik
BiLEt	BiLETik
surgUC	surgUCik
PEjs	PEjSik
eLektrOn	eLektrONik
krOL	krOLik
bOb	bOBik
mIs	mISik
TiPEc	Tip'Cik
cAR	cARik
Ad	ADik
SErp	SErPik
muhKEt	muhKETik
lOg	lOgik
ePizOd	ePizODik
tOr	tORik
laREc	lar'Cik
grOm	grOMik
stUl	stULik
gUS	gUSik
uhAt	uhATik
bloknOt	bloknOTik
kazAn	kazANik
dOgmat	dOgmaTik
KErn	KErNik
TAQ	TAQik
snOp	snOPik
MetAlloplAst	MetalloplAsTik
barAn	barANik
polOn	polONik
sPIrt	sPIrTik
oLeIn	oLeINik
sTEr	sTERik
podLEH	podLEHik
rogAL	rogALik
mAg	mAgik
brATec	brAtCik
tOrt	tOrTik
kRistAll	kRistAlLik
bObr	bObRik
bAstr	bAstRik
skVEr	skVERik
tUt	tUTik
gUl	gULik
klOp	klOPik
xomUt	xomUTik
boREc	bor'Cik
moloDEc	molod'Cik
vOQD	vOQDik
encefaLIt	encefaLITik
bUr	bURik
matrOs	matrOSik
MEC	MECik
CUm	CUMik
TIr	TIRik
pAl	pALik
BeREt	BeRETik
Um	UMik
TuTUn	TuTUNik
cVEt	cVETik
pAs	pASik
buKEt	buKETik
LEs	LESik
bAr	bARik
kArp	kArPik
kosTER	kosTERik
siREc	sir'Cik
lOm	lOMik
xrUH	xrUHik
svOd	svODik
htAb	htABik
sangVIn	sangVINik
mOst	mOsTik
snaRAd	snaRADik
nasOs	nasOSik
bOt	bOTik
gospodAR	gospodARik
jUr	jURik
KIt	KITik
PincEt	PincETik
vOz	vOZik
kREm	kREMik
procEnt	procEnTik
inTelLiGEnt	inTelLiGEnTik
xArC	xArCik
vodovorOt	vodovorOTik
koZOl	kOzLik
BIC	BICik
klAss	klAsSik
kanOn	kanONik
oSOl	OsLik
SEL	SELik
gId	gIDik
FErt	FErTik
lAz	lAZik
xvOst	xvOsTik
atLEt	atLETik
bRiKEt	bRiKETik
francUz	francUZik
zAd	zADik
stARec	stArCik
Az	AZik
rAd	rADik
pSIx	pSIXik
jAmb	jAmBik
kLUv	kLUVik
BInt	BInTik
rUbL	rUbLik
fOrt	fOrTik
zVER	zVERik
kursAnt	kursAnTik
KirPIC	KirPICik
CAs	CASik
kOh	kOhik
kOrt	kOrTik
QOr	QORik
fantAst	fantAsTik
rOv	rOVik
sandAl	sandALik
mAt	mATik
kaLendAR	kaLendARik
fOtoapparAt	fotoapparATik
pOl	pOLik
xrIC	xrICik
xOR	xORik
kotTEdQ	kotTEdQik
hKErt	hKErTik
tOm	tOMik
dvOr	dvORik
zuBEc	zub'Cik
REz	REZik
bUrt	bUrTik
fAkt	fAkTik
iOn	iONik
kuLIC	kuLICik
mOnstr	mOnstRik
QivOt	QivOTik
MetacEntr	MetacEntRik
portREt	portRETik
fUnt	fUnTik
stAn	stANik
SuQEt	SuQETik
TerRikOn	TerRikONik
mOt	mOTik
goLEc	gOLCik
gAz	gAZik
TeAtr	TeAtRik
gusAr	gusARik
DinozAvr	DinozAvRik
srUb	srUBik
bOrov	bOroVik
uxvAt	uxvATik
kRAQ	kRAQik
LEn	LENik
kubAR	kubARik
aNekdOt	aNekdOTik
DiaLEkt	DiaLEkTik
slovAR	slovARik
cEntr	cEntRik
podnOs	podnOSik
romAns	romAnSik
fAt	fATik
rOst	rOsTik
krOt	krOTik
CAl	CALik
bRiLjAnt	bRiLjAnTik
soldAt	soldATik
bagOr	bagORik
lAR	lARik
kOrd	kOrDik
kaDEt	kaDETik
kanUn	kanUNik
pAss	pAsSik
grOb	grOBik
sosUd	sosUDik
grUz	grUZik
aRistokrAt	aRistokrATik
grAn	grANik
vodopAd	vodopADik
ZAT	ZATik
rUst	rUsTik
jUz	jUZik
ekzOt	ekzOTik
grOh	grOhik
PejzAQ	PejzAQik
QurAvL	QurAvLik
magNIt	magNITik
pUps	pUpSik
karAS	karASik
bAnt	bAnTik
hkAf	hkAFik
xRAH	xRAHik
Erl	ErLik
vOl	vOLik
vAl	vALik
ObruC	ObruCik
kAnt	kAnTik
Ost	OsTik
svAt	svATik
FInn	FInNik
lOt	lOTik
aRestAnt	aRestAnTik
suxAR	suxARik
lUN	lUNik
grAC	grACik
nOL	nOLik
gnOm	gnOMik
lAvr	lAvRik
ruLEt	ruLETik
jeLEc	jELCik
kUb	kUBik
fOrd	fOrDik
maLAr	maLARik
aromAt	aromATik
gAd	gADik
xOn	xONik
HUp	HUPik
VEpR	VEpRik
pUl	pULik
TeploxOd	TeploxODik
tOp	tOPik
glAz	glAZik
kREst	kREsTik
kolxOz	kolxOZik
prIH	prIHik
arAb	arABik
LUd	LUDik
brasLEt	brasLETik
kUs	kUSik
xalAt	xalATik
trOs	trOSik
DEtsAd	DetsADik
xrustAL	xrustALik
TitAn	TitANik
zabOr	zabORik
PiSEc	Pis'Cik
grAf	grAFik
lUC	lUCik
staTIst	staTIsTik
korAbL	korAbLik
QAr	QARik
knUt	knUTik
QgUt	QgUTik
poklOn	poklONik
VInt	VInTik
bArs	bArSik
pUf	pUFik
orgAn	orgANik
stOl	stOLik
voprOs	voprOSik
raXIt	raXITik
tAkt	tAkTik
saTIr	saTIRik
tUz	tUZik
gOrb	gOrBik
NefRIt	NefRITik
sxolAst	sxolAsTik
stUDeN	stUDeNik
mAz	mAZik
kartUz	kartUZik
lOS	lOSik
kOvh	kOvhik
kULt	kULTik
xAdQ	xAdQik
xLUp	xLUPik
xlIst	xlIsTik
bUt	bUTik
QIr	QIRik
hpUnt	hpUnTik
vkUs	vkUSik
MerzAVec	MerzAvCik
SinkLIt	SinkLITik
kOpt	kOpTik
pLUs	pLUSik
EL	ELik
rOl	rOLik
loskUt	loskUTik
dAr	dARik
roDIMec	roDImCik
PErs	PErSik
patrONim	patrONiMik
avAns	avAnSik
LetoPISec	LetoPIsCik
paroxOd	paroxODik
SITec	SItCik
mOl	mOLik
sugrOb	sugrOBik
trUp	trUPik
sOkol	sOkoLik
SekRETec	SekREtCik
htAmb	htAmBik
krOn	krONik
tAz	tAZik
pATer	pATeRik
kAt	kATik
kalAC	kalACik
jER	jERik
portFEL	portFELik
TEnor	TEnoRik
krAn	krANik
arbUz	arbUZik
stuDEnt	stuDEnTik
hIp	hIPik
sCastLIVec	sCastLIvCik
soVEt	soVETik
oguREc	ogur'Cik
slOn	slONik
PeskAR	PeskARik
PERec	PErCik
Ant	AnTik
apparAt	apparATik
sOm	sOMik
stOlb	stOlBik
zOb	zOBik
PEst	PEsTik
hEst	hEsTik
talAnt	talAnTik
puzIR	puzIRik
pAQ	pAQik
esTEt	esTETik
nakAt	nakATik
uzDEN	uzDENik
bOr	bORik
LEH	LEHik
Test forms:
barsUk
maNjAk
kamIh
anCOus
BinOkL
kOmpLeks
kOMiks
karAS
MERin
DEVeR
abaQUr
pArus
BinDUg
akvARium
mAsTer
gOluB
avAns
orKEstr
FENiks
krokoDIl
oVOs
maLAr
bokSOr
Atom
tabUn
lAZer
Idol
PenAl
ceMEnt
CerTOQ
kadIk
CetVErg
eDeLVEjs
molLUsk
stoLAr
psalOm
oLeAndr
basSEjn
CabAn
PERePel
arxAnGel
VIKing
HegOl
podsOlnux
KiSEL
ekzAMen
tRUFeL
eksPErt
QurAvL
QOlob
OPium
OvoH
VixOr
rukAv
hELep
DiLiQAns
antrAkt
hkoLAr
QEmCug
hULer
monOkL
xOmut
SImvol
pUDing
BIceps
kAPers
kOQux
kokTEjL
GErcog
tAbor
fAKel
golKIPer
spOsob
anAtom
kOnsul
sUfFiks
jePIskop
pOjezd
aboRiGEn
BiLjArd
xoZAin
VEsTern
PiTekAntrop
kamzOl
juRIst
kombAjn
kanNibAl
dUpLeks
kOnus
soAvtor
mosOl
tarAntul
ekViLibRIst
Otpusk
mAmont
vIbor
FiTIL
LEmMing
klOun
okTAbR
RituAl
etAQ
BidOn
DinozAvr
sOkol
pOgReb
adjutAnt
dQEmPer
QOluD
paraBEllum
Okorok
Aist
posOl
CuvAk
asTerOid
uCITeL
pAsport
fOrum
klUb
kOndor
pOLus
pSixOlog
kazAk
BISer
kOCet
vALdhNep
bATik
CexOl
oBeLIsk
vOlos
QERex
fLIGeL
gusLAr
burgoMIstr
mihjAk
GepArd
paLindrOm
OrDen
garAQ
gusAr
golIh
vAlux
kostIL
kLEVer
adApTer
haTOr
hpagAt
astronOm
hatUn
ajfOn
BErkut
DiRiQAbL
oSOtr
PeRiskOp
avtObus
hOmpol
CERep
kaskaDOr
motocIkl
xObot
aViAtor
poNeDELNik
korotIh
kOrob
bARin
vImPel
slovAk
end