n ny	ɲː
ccs	tː ʃ
c c	tː sz
t t	tː
n g	ŋ ɡ
dzs	d ʒ
g gy	ɟː
r r	rː
n n	nː
g g	ɡː
p p	pː
k k	kː
f f	fː
ssz	sː
l l	lː
b b	bː
d d	dː
v v	vː
j j	jː
d t	tː
ny	ɲ
gy	ɟ
ly	j
zs	ʒ
cs	t ʃ
s s	ʃː
g	ɡ
w	v
dz	d z
a	ɒ
A	aː
O	oː
U	uː
oe	ø
OE	øː
I	iː
ue	y
UE	yː
e	ɛ
E	eː
