c	k
v	w
x	ks
ŭ	u
ă	a
ĕ	e
ĭ	i
ŏ	o
ā	a:
ē	e:
ī	i:
ō	o:
ū	u:
pp	p:
tt	t:
kk	k:
bb	b:
dd	d:
gg	g:
mm	m:
ll	l:
nn	n:
rr	r:
ss	s:
y	i
ȳ	i:
gui	gwi
gua	gwa
gue	gwe
guo	gwo
guu	gwu
qu	kw
